date,vaccination.administered,vaccination.administered.todate,vaccination.administered2nd,vaccination.administered2nd.todate,vaccination.used.todate
2020-12-27,6039,6039,,,6039
2020-12-28,1547,7586,,,7586
2020-12-29,1238,8824,,,8824
2020-12-30,392,9216,,,9216
2020-12-31,1855,11071,,,11071
2021-01-01,150,11221,,,11221
2021-01-02,404,11625,,,11625
2021-01-03,555,12180,,,12180
2021-01-04,1080,13260,,,13260
2021-01-05,2467,15727,,,15727
2021-01-06,5285,21012,,,21012
2021-01-07,5457,26469,,,26469
2021-01-08,3221,29690,1,1,29691
2021-01-09,254,29944,,1,29945
2021-01-10,1,29945,,1,29946
2021-01-11,484,30429,,1,30430
2021-01-12,1804,32233,,1,32234
2021-01-13,4697,36930,1,2,36932
2021-01-14,6671,43601,1,3,43604
2021-01-15,4766,48367,150,153,48520
2021-01-16,324,48691,,153,48844
2021-01-17,4,48695,,153,48848
2021-01-18,62,48757,166,319,49076
2021-01-19,555,49312,1614,1933,51245
2021-01-20,1158,50470,3527,5460,55930
2021-01-21,1327,51797,3386,8846,60643
2021-01-22,1207,53004,968,9814,62818
2021-01-23,230,53234,483,10297,63531
2021-01-24,16,53250,133,10430,63680
2021-01-25,3,53253,4,10434,63687
2021-01-26,86,53339,1747,12181,65520
2021-01-27,287,53626,4766,16947,70573
2021-01-28,525,54151,5585,22532,76683
2021-01-29,564,54715,4010,26542,81257
2021-01-30,11,54726,105,26647,81373
2021-01-31,-28077,26649,,26647,53296
2021-02-01,28100,54749,32,26679,81428
2021-02-02,17,54766,1097,27776,82542
2021-02-03,196,54962,4612,32388,87350
2021-02-04,658,55620,6741,39129,94749
2021-02-05,419,56039,5224,44353,100392
2021-02-06,28,56067,573,44926,100993
2021-02-07,,56067,,44926,100993
2021-02-08,398,56465,,44926,101391
2021-02-09,88,56553,31,44957,101510
2021-02-10,2497,59050,712,45669,104719
2021-02-11,6823,65873,1768,47437,113310
2021-02-12,6877,72750,1738,49175,121925
2021-02-13,710,73460,189,49364,122824
2021-02-14,16,73476,16,49380,122856
2021-02-15,78,73554,8,49388,122942
2021-02-16,1044,74598,71,49459,124057
2021-02-17,4917,79515,623,50082,129597
2021-02-18,8306,87821,728,50810,138631
2021-02-19,6141,93962,600,51410,145372
2021-02-20,2518,96480,20,51430,147910
2021-02-21,1,96481,,51430,147911
2021-02-22,472,96953,3,51433,148386
2021-02-23,1522,98475,7,51440,149915
2021-02-24,6790,105265,186,51626,156891
2021-02-25,10750,116015,190,51816,167831
2021-02-26,7224,123239,543,52359,175598
2021-02-27,916,124155,10,52369,176524
2021-02-28,,124155,,52369,176524
2021-03-01,1137,125292,,52369,177661
2021-03-02,2166,127458,11,52380,179838
2021-03-03,6548,134006,884,53264,187270
2021-03-04,6729,140735,4569,57833,198568
2021-03-05,4610,145345,5684,63517,208862
2021-03-06,1347,146692,594,64111,210803
2021-03-07,,146692,,64111,210803
2021-03-08,1409,148101,394,64505,212606
2021-03-09,3686,151787,495,65000,216787
2021-03-10,4681,156468,4925,69925,226393
2021-03-11,6109,162577,7850,77775,240352
2021-03-12,8382,170959,5111,82886,253845
2021-03-13,6175,177134,2160,85046,262180
2021-03-14,1,177135,,85046,262181
2021-03-15,1335,178470,293,85339,263809
2021-03-16,270,178740,781,86120,264860
2021-03-17,455,179195,5685,91805,271000
2021-03-18,1685,180880,8390,100195,281075
2021-03-19,2998,183878,4472,104667,288545
2021-03-20,4056,187934,179,104846,292780
2021-03-21,,187934,,104846,292780
2021-03-22,1120,189054,9,104855,293909
2021-03-23,3935,192989,312,105167,298156
2021-03-24,7337,200326,2580,107747,308073
2021-03-25,11861,212187,2526,110273,322460
2021-03-26,13702,225889,2282,112555,338444
2021-03-27,6750,232639,493,113048,345687
2021-03-28,1258,233897,3,113051,346948
2021-03-29,1125,235022,7,113058,348080
2021-03-30,7550,242572,317,113375,355947
2021-03-31,13321,255893,1306,114681,370574
2021-04-01,16681,272574,2661,117342,389916
2021-04-02,9837,282411,2088,119430,401841
2021-04-03,2991,285402,19,119449,404851
2021-04-04,1591,286993,2,119451,406444
2021-04-05,,286993,,119451,406444
2021-04-06,2450,289443,360,119811,409254
2021-04-07,6132,295575,20,119831,415406
2021-04-08,14713,310288,650,120481,430769
2021-04-09,18475,328763,1685,122166,450929
2021-04-10,9052,337815,129,122295,460110
2021-04-11,1609,339424,13,122308,461732
2021-04-12,1652,341076,203,122511,463587
2021-04-13,3076,344152,724,123235,467387
2021-04-14,7783,351935,3830,127065,479000
2021-04-15,9449,361384,9939,137004,498388
2021-04-16,8422,369806,5658,142662,512468
2021-04-17,2507,372313,3637,146299,518612
2021-04-18,1273,373586,7,146306,519892
2021-04-19,2325,375911,373,146679,522590
2021-04-20,5214,381125,1455,148134,529259
2021-04-21,7741,388866,9053,157187,546053
2021-04-22,8131,396997,11773,168960,565957
2021-04-23,10840,407837,6745,175705,583542
2021-04-24,2505,410342,425,176130,586472
2021-04-25,659,411001,17,176147,587148
2021-04-26,379,411380,7,176154,587534
2021-04-27,461,411841,5,176159,588000
2021-04-28,3209,415050,4625,180784,595834
2021-04-29,5955,421005,12992,193776,614781
2021-04-30,6200,427205,14668,208444,635649
2021-05-01,1052,428257,5897,214341,642598
2021-05-02,1289,429546,2149,216490,646036
2021-05-03,4692,434238,2807,219297,653535
2021-05-04,7182,441420,2743,222040,663460
2021-05-05,9747,451167,7750,229790,680957
2021-05-06,14974,466141,11898,241688,707829
2021-05-07,13382,479523,8520,250208,729731
2021-05-08,5499,485022,5150,255358,740380
2021-05-09,1672,486694,120,255478,742172
2021-05-10,2329,489023,1371,256849,745872
2021-05-11,8213,497236,2099,258948,756184
2021-05-12,16289,513525,5560,264508,778033
2021-05-13,16717,530242,8593,273101,803343
2021-05-14,4651,534893,6205,279306,814199
